leçons|Les leçons de mathématiques étaient difficiles.|Nom masculin|уроки
tort|Il a commis une erreur et a admis son tort.|Nom masculin|ошибка
marchait|Il marchait lentement dans le parc.|Verbe|шёл
fantôme|Un fantôme est apparu dans la vieille maison.|Nom masculin|призрак
diète|Elle suit une diète stricte pour perdre du poids.|Nom féminin|диета
meurt|Il meurt d'envie de voyager à l'étranger.|Verbe|умирает
quitterai|Je te quitterai si tu continues à mentir.|Verbe|покину
pouc|Il a une écharde dans le pouce.|Nom masculin|палец
tient|Elle tient un bouquet de fleurs fraîches.|Verbe|держит
huîtres|Les huîtres sont un mets délicat en France.|Nom féminin|устрицы
lesquels|Lesquels de ces gâteaux préférez-vous?|Pronom interrogatif|который
laissez|Laissez-moi vous aider avec vos bagages.|Verbe|оставьте
demain|Nous nous retrouverons demain matin.|Adverbe de temps|завтра
attendra|Il t'attendra devant la gare.|Verbe|подождет
mouillés|Ils sont rentrés à la maison tout mouillés.|Adjectif|мокрые
entre|Il est assis entre ses amis.|Préposition|между
nirait|Elle nirait jamais à cet endroit sombre.|Verbe|пойдет
gigot|Le gigot d'agneau était délicieux.|Nom masculin|бараний окорок
maintes|Il a fait maintes tentatives pour réussir.|Adjectif|множество
ai|J'ai beaucoup à faire aujourd'hui.|Verbe|иметь
guetter|Il se cachait pour guetter l'arrivée de son ami.|Verbe|подсматривать
chers|Ces bijoux sont très chers.|Adjectif|дорогие
plaindrait|Elle plaindrait souvent de maux de tête.|Verbe|жалуется
signale|Le panneau signale un virage dangereux.|Verbe|указывать
sympathie|Il a beaucoup de sympathie pour les animaux.|Nom féminin|симпатия
famille|La famille se réunit pour les vacances.|Nom féminin|семья
peigner|Elle aime se peigner les cheveux le matin.|Verbe|чесать
air|L'air était frais et pur en montagne.|Nom masculin|воздух
petite|Cette poupée est très petite.|Adjectif|маленькая
aiguille|Elle a cousu le bouton avec une aiguille.|Nom féminin|игла
prenait|Il prenait son petit-déjeuner quand je suis arrivé.|Verbe|брал
chimie|La chimie est une matière difficile à l'école.|Nom féminin|химия
galopais|Le cheval galopais à toute vitesse.|Verbe|галопировал
pleurant|Elle était assise dans sa chambre, pleurant.|Verbe|плача
affaires|Il est occupé avec ses affaires toute la journée.|Nom féminin|дела
prépare|Elle prépare un gâteau pour l'anniversaire.|Verbe|готовит
éponge|L'éponge est utilisée pour nettoyer la vaisselle.|Nom féminin|губка
tubes|Les tubes contiennent différents types de peinture.|Nom masculin|тюбики
boxe|Il pratique la boxe depuis son enfance.|Nom féminin|бокс
surpri|Elle a été surprise par cette nouvelle.|Verbe|удивлена
vion|Il a pris un vion pour partir en vacances.|Nom masculin|самолет
reculé|Il a reculé lorsque le chien a aboyé.|Verbe|отступил
prévenu|Il m'avait prévenu de ne pas oublier mon parapluie.|Verbe|предупрежден
semblé|Il semblé heureux de la nouvelle.|Verbe|казалось
attaché|Il est attaché à son vieux chien.|Adjectif|привязан
prends|Je prends le bus pour aller au travail.|Verbe|беру
canon|Le canon de la caméra est très puissant.|Nom masculin|канон
maixent|Maixent est le nom de leur chien.|Nom propre|Максан
moitié|Elle a partagé son dessert en moitié.|Nom féminin|половина
su|Je suis suivi par un chaton mignon.|Verbe|следят
buanderie|La buanderie est l'endroit où l'on fait la lessive.|Nom féminin|прачечная
idée|Il a une idée brillante pour résoudre ce problème.|Nom féminin|идея
voya|Il voya un oiseau rare dans le jardin.|Verbe|увидел
sache|Sache que je serai toujours là pour toi.|Verbe|знай
garnements|Ces garnements sont en train de jouer dans la rue.|Nom masculin|шалунишки
vél|Elle a un vél en bon état pour se déplacer.|Nom masculin|велосипед
foul|Il a fait un foul lors du match de football.|Nom masculin|фол
fâcher|Il ne faut pas se fâcher pour si peu.|Verbe|сердиться
tenu|Il était bien tenu dans son costume élégant.|Adjectif|одет
brillaient|Les étoiles brillaient dans le ciel nocturne.|Verbe|сверкали
moment|C'était un moment inoubliable de sa vie.|Nom masculin|момент
entré|Il est entré discrètement dans la pièce.|Verbe|вошел
venus|Ils sont venus nous rendre visite cet après-midi.|Verbe|пришли
brillantine|La brillantine est utilisée pour coiffer les cheveux.|Nom féminin|бриллиантин
serons|Nous serons bientôt là.|Verbe|будем
chocolats|Les chocolats sont une délicieuse gourmandise.|Nom masculin|шоколад
allons|Nous allons au cinéma ce soir.|Verbe|идем
rends|Je me rends au travail en bus tous les jours.|Verbe|еду
prendre|Il faut prendre des décisions importantes.|Verbe|принимать
dirait|Il dirait n'importe quoi pour impressionner les autres.|Verbe|говорит
éloigné|Le village est éloigné de la ville.|Adjectif|удален
poing|Il a serré son poing avec colère.|Nom masculin|кулак
envie|J'ai envie de manger une glace.|Nom féminin|желание
anniversaire|Nous célébrons son anniversaire demain.|Nom masculin|день рождения
mettait|Elle mettait du rouge à lèvres avant de sortir.|Verbe|накладывала
hélice|L'hélice de l'avion tourne rapidement.|Nom féminin|винт
voilà|Voilà le cadeau que j'ai acheté pour toi.|Adverbe|вот
bons|Les bons amis sont difficiles à trouver.|Adjectif|хорошие
bureau|Il travaille dans un grand bureau.|Nom masculin|офис
prouve|Il prouve toujours qu'il a raison.|Verbe|доказывает
enfin|Enfin, le week-end est arrivé.|Adverbe|наконец
emmèneraient|Ils t'emmèneraient à la plage si tu leur demandais.|Verbe|отвезли бы
ronde|Ils ont dansé une ronde joyeuse lors de la fête.|Nom féminin|круговорот
boum|Il y a eu un boum fort, suivi d'un silence.|Onomatopée|бум
inquiète|Elle est inquiète pour son avenir.|Adjectif|встревожена
fable|La fable raconte une histoire morale.|Nom féminin|басня
soignée|Elle est toujours bien soignée et élégante.|Adjectif|ухоженная
rester|Il prévoit de rester à la maison ce week-end.|Verbe|остаться
outils|Les outils sont rangés dans le garage.|Nom masculin|инструменты
lever|Il aime regarder le lever du soleil le matin.|Verbe|подниматься
moustaches|Les moustaches du chat sont très douces.|Nom féminin|усы
drapeau|Le drapeau national flotte au sommet du bâtiment.|Nom masculin|флаг
quoi|Elle ne sait pas quoi faire dans cette situation.|Pronom interrogatif|что
un|Il a un chat noir comme animal de compagnie.|Article indéfini|один
mes|Mes amis viendront me rendre visite ce soir.|Adjectif possessif|мои
traduire|Il peut traduire des textes en plusieurs langues.|Verbe|перевести
joyeux|Ils étaient joyeux lors de la fête d'anniversaire.|Adjectif|веселые
et|Il aime le chocolat et les bonbons.|Conjonction|и
clients|Les clients sont impatients d'obtenir de l'aide.|Nom masculin|клиенты
rencontrer|Il va rencontrer son ami à la bibliothèque.|Verbe|встретить
sage|Le vieil homme était sage et plein de sagesse.|Adjectif|мудрый
sciences|Les sciences sont une partie essentielle de l'éducation.|Nom féminin|наука
lunettes|Elle porte des lunettes pour lire.|Nom féminin|очки
viendrai|Je viendrai te rendre visite demain.|Verbe|приду
effet|L'effet de la lumière sur l'eau était magnifique.|Nom masculin|эффект
habiller|Elle aime s'habiller élégamment pour les occasions spéciales.|Verbe|одеваться
dingue|Il est un peu dingue, mais on l'aime comme ça.|Adjectif|сумасшедший
robinets|Les robinets de la cuisine fuient.|Nom masculin|краны
des|Il y a des livres sur l'étagère.|Article indéfini|несколько
allumette|Elle a allumé une allumette pour éclairer la pièce sombre.|Nom féminin|спичка
ri|Ils rient ensemble de leurs blagues.|Verbe|смеются
explosaient|Les pétards explosaient dans le ciel pendant la fête.|Verbe|взрывались
mets|Va fermer la porte, mets les verrous.|Nom masculin|блюда
poupé|Elle collectionne des poupées en porcelaine anciennes.|Nom féminin|кукла
crier|Il aime crier des slogans lors des manifestations.|Verbe|кричать
rôti|Le rôti était tendre et savoureux.|Nom masculin|жаркое
aidé|Il m'a aidé à résoudre le problème.|Verbe|помог
posé|Il a posé le livre sur la table.|Verbe|положил
attacher|Il faut attacher la ceinture de sécurité en voiture.|Verbe|пристегнуть
auto|Il a acheté une nouvelle auto de luxe.|Nom féminin|автомобиль
ramènerais|Je te ramènerais à la maison après la fête.|Verbe|привез бы
pardi|Pardi, c'était une soirée mémorable !|Interjection|черт возьми
venir|Ils vont venir nous rejoindre à la plage.|Verbe|придут
essuyé|Il a essuyé la table après le dîner.|Verbe|вытер
vacances|Elle est en vacances à la plage pendant deux semaines.|Nom féminin|каникулы
saignait|La blessure saignait abondamment.|Verbe|кровоточила
anité|La qualité de son travail était d'une grande anité.|Nom féminin|качество
grotesque|Son costume était si grotesque que tout le monde a ri.|Adjectif|гротескный
aimais|Quand j'étais enfant, j'aimais les contes de fées.|Verbe|любил
sur|Il est assis sur un banc dans le parc.|Préposition|на
appétissant|La pizza avait l'air très appétissante.|Adjectif|аппетитный
images|Les images dans le livre sont magnifiques.|Nom féminin|изображения
priver|Il ne faut pas priver les enfants de leurs rêves.|Verbe|лишать
pages|Le livre a des centaines de pages.|Nom féminin|страницы
mourir|Tout le monde doit mourir un jour.|Verbe|умирать
bateau|Le bateau a navigué sur l'océan.|Nom masculin|лодка
plaint|Elle se plaint souvent du froid en hiver.|Verbe|жалуется
assise|Elle était assise sur le banc en attendant son ami.|Nom féminin|сидение
pouva|Elle pouva le mystère de la vieille maison hantée.|Verbe|разгадала
mioche|Le mioche est toujours en train de poser des questions.|Nom masculin|сорванец
pices|Il a trouvé des pices dans le sable de la plage.|Nom féminin|монеты
restait|Il restait calme en dépit de la situation stressante.|Verbe|оставался
touche|Appuyez sur la touche pour démarrer le jeu.|Nom féminin|кнопка
dommage|C'est dommage que nous ayons raté le train.|Nom masculin|жаль
attraper|Il a réussi à attraper le ballon.|Verbe|поймать
marseillaise|La Marseillaise est l'hymne national de la France.|Nom féminin|Марсельеза
cotisent|Ils cotisent régulièrement à une œuvre caritative.|Verbe|вносят взносы
patte|Le chat a une patte blessée.|Nom féminin|лапа
gnols|Les gnols ont envahi le jardin.|Nom masculin|гномы
ramasser|Il doit ramasser les feuilles mortes dans le jardin.|Verbe|собирать
garderait|Elle garderait précieusement son bijou hérité.|Verbe|хранит
arbitre|L'arbitre a sifflé la fin du match de football.|Nom masculin|судья
amuse|Le cirque amuse les enfants et les adultes.|Verbe|развлекает
perdus|Ils se sont perdus dans la forêt dense.|Adjectif|потерянные
tache|La tache sur le tapis était difficile à enlever.|Nom féminin|пятно
annonce|L'annonce du mariage a été faite en grand.|Nom féminin|объявление
objectif|Il a atteint son objectif de remise en forme.|Nom masculin|цель
sale|La cuisine était sale après le dîner.|Adjectif|грязная
curieux|Les enfants sont naturellement curieux.|Adjectif|любопытные
carabas|Carabas est un personnage de conte.|Nom propre|Карабас
pleuvoir|Il commence à pleuvoir, prenons un parapluie.|Verbe|идет дождь
séparés|Ils se sont séparés après de nombreuses années de mariage.|Adjectif|раздельные
cassent|Les enfants cassent souvent leurs jouets.|Verbe|ламают
soupir|Elle a laissé échapper un soupir de soulagement.|Nom masculin|вздох
frottait|Il frottait la table pour la rendre propre.|Verbe|треть
toit|Le chat est monté sur le toit de la maison.|Nom masculin|крыша
mois|Le mois de décembre est le mois de Noël.|Nom masculin|месяц
comiques|Les comiques ont fait rire le public pendant le spectacle.|Adjectif|комические
faudrait|Il faudrait plus de temps pour terminer ce projet.|Verbe|нужно
montré|Il a montré la direction à suivre.|Verbe|показал
école|L'école est un lieu d'apprentissage important.|Nom féminin|школа
sandales|Elle porte des sandales pour se promener sur la plage.|Nom féminin|сандалии
miettes|Les miettes de pain attirent les oiseaux.|Nom féminin|крошки
tout|Il a tout pour réussir dans la vie.|Pronom indéfini|все
aille|Il faut qu'il aille chez le médecin.|Verbe|пойдет
habitude|Il a pris l'habitude de faire de l'exercice tous les matins.|Nom féminin|привычка
composition|La composition florale est magnifique.|Nom féminin|композиция
battant|Il a gagné en battant son adversaire.|Verbe|победив
quitter|Il ne voulait pas quitter ses amis.|Verbe|покинуть
verres|Les verres sont posés sur la table pour le dîner.|Nom masculin|стаканы
retenue|Il a montré une grande retenue dans sa réaction.|Nom féminin|сдержанность
rousseur|Les taches de rousseur sur son visage étaient adorables.|Nom féminin|веснушки
saurait|Il saurait résoudre ce problème compliqué.|Verbe|знал бы
lignes|Les lignes droites sont parfaites en géométrie.|Nom féminin|линии
sûr|Il est sûr de sa décision.|Adjectif|уверен
jouent|Les enfants jouent dans le parc cet après-midi.|Verbe|играют
sempé|Il a sempé le papier pour le rendre plus solide.|Verbe|оклеил
renvoye|Il a été renvoye de son emploi pour faute grave.|Verbe|уволен
répétition|La répétition de la pièce de théâtre était longue.|Nom féminin|повторение
fusil|Il a nettoyé son fusil de chasse après la partie.|Nom masculin|ружье
refusait|Il refusait de manger ses légumes.|Verbe|отказывался
seul|Il était seul dans la pièce.|Adjectif|один
attendait|Elle attendait son ami à la gare depuis longtemps.|Verbe|ждала
cloche|La cloche sonne pour annoncer la fin de la journée d'école.|Nom féminin|колокол
raté|Il a raté le panier lors du match de basketball.|Adjectif|промах
sagement|Il a écouté sagement les conseils de son professeur.|Adverbe|мудро
gifles|Il a reçu deux gifles pour son comportement.|Nom féminin|пощечины
plumeau|Elle a utilisé un plumeau pour nettoyer les étagères.|Nom masculin|пыльца
cupé|Il était cupé dans la bibliothèque toute la journée.|Adjectif|занятый
courte|La jupe est un peu courte, n'est-ce pas ?|Adjectif|короткая
chiffonné|Il a chiffonné le papier et l'a jeté à la poubelle.|Adjectif|помяты
gorge|Elle a mal à la gorge et tousse beaucoup.|Nom féminin|горло
dangereux|Ce serpent est dangereux, ne t'approche pas.|Adjectif|опасный
taire|Il a préféré se taire pour ne pas blesser ses sentiments.|Verbe|молчать
valait|La peinture ancienne valait une petite fortune.|Verbe|стоило
changeait|Elle changeait de coiffure régulièrement.|Verbe|менялась
métal|Le métal est un matériau solide et durable.|Nom masculin|металл
capitaine|Le capitaine du navire a une grande responsabilité.|Nom masculin|капитан
frappe|Il a une frappe puissante au football.|Nom féminin|удар
boîte|Il a ouvert la boîte avec précaution.|Nom féminin|коробка
nourri|Les animaux du zoo sont bien nourri.|Verbe|кормят
vise|Il vise soigneusement la cible.|Verbe|целится
gnan|Il est un vrai gnan en classe, toujours prêt à répondre.|Nom masculin|знаток
attendu|Il a attendu des heures pour obtenir un autographe.|Verbe|ждал
plaît|Le dessert plaît à tout le monde.|Verbe|нравится
obéis|Il obéis à ses parents sans poser de questions.|Verbe|подчиняется
mordre|Le chien peut mordre s'il se sent menacé.|Verbe|кусать
regarder|Il aime regarder les étoiles la nuit.|Verbe|смотреть
pous|Les pous sont des parasites qui infestent les cheveux.|Nom masculin|вши
guirlandes|Les guirlandes lumineuses éclairent la pièce.|Nom féminin|гирлянды
attendaient|Ils attendaient avec impatience le début du concert.|Verbe|ждали
cartable|Il a oublié son cartable à l'école.|Nom masculin|рюкзак
coûte|Le voyage en avion coûte cher.|Verbe|стоит
bonne|Elle est une bonne élève à l'école.|Adjectif|хорошая
revenir|Il va revenir bientôt de son voyage d'affaires.|Verbe|вернется
directeur|Le directeur de l'entreprise est très compétent.|Nom masculin|директор
pratique|Le yoga est une pratique bénéfique pour le corps.|Nom féminin|практика
train|Le train partira de la gare à 15 heures.|Nom masculin|поезд
ront|Ils ront bientôt une nouvelle série télévisée.|Verbe|снимут
parfaitement|Il parle parfaitement plusieurs langues étrangères.|Adverbe|прекрасно
pu|Il a pu résoudre l'énigme en un instant.|Verbe|смог
liquides|Il faut transporter les liquides avec précaution.|Nom masculin|жидкости
entraîner|L'exercice physique régulier peut entraîner une meilleure santé.|Verbe|привести
pluie|La pluie a commencé à tomber doucement.|Nom féminin|дождь
verra|Il te verra à la réunion demain.|Verbe|увидит
bord|Ils sont assis au bord de la piscine.|Nom masculin|край
jetés|Ils ont jetés les vieux meubles à la décharge.|Verbe|бросили
histoires|Il aime lire des histoires avant de dormir.|Nom féminin|рассказы
épicerie|Elle a fait ses courses à l'épicerie du coin.|Nom féminin|продуктовый магазин
midi|Il déjeune généralement à midi.|Nom masculin|полдень
étions|Nous étions amis depuis l'enfance.|Verbe|были
expliquait|Il expliquait le concept de manière claire.|Verbe|объяснял
gênée|Elle se sent gênée dans les situations sociales.|Nom féminin|неловкость
vexée|Elle est vexée par les commentaires désobligeants.|Verbe|обижена
accord|Ils sont en accord sur cette question importante.|Nom masculin|согласие
dictée|La dictée était difficile, mais il a bien travaillé.|Nom féminin|диктант
camarade|Il est un bon camarade de classe.|Nom masculin|товарищ
réflexions|Il a fait des réflexions profondes sur la philosophie.|Nom féminin|размышления
invitée|Elle a invitée des amis à dîner ce soir.|Nom féminin|гость
sorties|Les sorties en plein air sont bénéfiques pour la santé.|Nom féminin|прогулки
arrive|Il arrive en retard à toutes les réunions.|Verbe|приходит
étendard|Le drapeau est l'étendard de la nation.|Nom masculin|знамя
panoplie|La panoplie du super-héros était impressionnante.|Nom féminin|аппарат
passent|Les années passent vite.|Verbe|проходят
yeux|Les yeux sont le miroir de l'âme.|Nom masculin|глаза
tête|Elle a mal à la tête à cause du bruit.|Nom féminin|голова
sourire|Son sourire lumineux égaye la journée de tout le monde.|Nom masculin|улыбка
devrait|Il devrait prendre des décisions importantes.|Verbe|должен
verser|Il va verser un verre de vin pour elle.|Verbe|нальет
lieu|Le lieu de la réunion a été changé au dernier moment.|Nom masculin|место
âge|À son âge, elle est encore en forme.|Nom masculin|возраст
sont|Ils sont de bons amis depuis l'enfance.|Verbe|являются
ore|Il a une jolie boucle d'oreille en argent.|Nom féminin|ухо
bientôt|Le week-end arrivera bientôt, ne t'inquiète pas.|Adverbe|скоро
traînant|Il a marché en traînant les pieds.|Verbe|тянущий
pressé|Il est toujours pressé le matin pour aller travailler.|Adjectif|торопится
ingrat|Il est ingrat de ne pas reconnaître sa gentillesse.|Adjectif|неблагодарный
peur|La peur l'a paralysé pendant un moment.|Nom féminin|страх
envoi|L'envoi du colis a été retardé en raison de la tempête.|Nom masculin|отправка
rendu|Il a rendu le livre emprunté à la bibliothèque.|Verbe|вернул
baigner|Les enfants aiment se baigner dans la piscine en été.|Verbe|купаться
alceste|Alceste est un personnage de la pièce de Molière.|Nom propre|Альсест
marteau|Il a utilisé un marteau pour clouer le tableau au mur.|Nom masculin|молоток
pièce|Il a perdu une pièce de puzzle.|Nom féminin|деталь
marché|Le marché est animé le matin avec de nombreux stands.|Nom masculin|рынок
pareilles|Les histoires étaient toutes pareilles.|Adjectif|похожие
plaisir|C'était un plaisir de vous rencontrer.|Nom masculin|удовольствие
hautes|Les montagnes sont hautes et majestueuses.|Adjectif|высокие
justement|Elle a répondu justement à la question difficile.|Adverbe|точно
trois|Il a trois enfants merveilleux.|Numéral|три
dessins|Les dessins de l'enfant sont créatifs et colorés.|Nom masculin|рисунки
étuis|Les étuis de téléphone sont disponibles dans de nombreuses couleurs.|Nom masculin|чехлы
santé|La santé est précieuse, prenons-en soin.|Nom féminin|здоровье
feu|Le feu est nécessaire pour cuisiner.|Nom masculin|огонь
vélo|Il adore faire du vélo dans le parc.|Nom masculin|велосипед
commencer|Il est temps de commencer le projet.|Verbe|начать
une|Il a besoin d'une nouvelle voiture.|Article indéfini|одну
apprenne|Il apprenne rapidement de nouvelles compétences.|Verbe|учится
avaient|Ils avaient de grands rêves pour l'avenir.|Verbe|имели
devinerez|Vous ne devinerez jamais la réponse à cette énigme.|Verbe|угадаете
premier|Il a été le premier à arriver à la réunion.|Adjectif|первый
remplit|Il remplit son verre avec de l'eau fraîche.|Verbe|налил
loin|Le voyage à la montagne est loin de la ville.|Adverbe|далеко
respirer|Il a besoin de respirer profondément pour se calmer.|Verbe|дышать
côtés|Il a dessiné des oiseaux sur les côtés de sa boîte à lunch.|Nom masculin|стороны
emmènerai|Je t'emmènerai au parc cet après-midi.|Verbe|повезу
dessiner|Elle aime dessiner des paysages magnifiques.|Verbe|рисовать
libre|Le week-end, il aime se détendre et se sentir libre.|Adjectif|свободный
dois|Tu dois finir tes devoirs avant de sortir jouer.|Verbe|должен
marcher|Elle préfère marcher jusqu'au travail pour faire de l'exercice.|Verbe|идти
tu|Tu es mon meilleur ami.|Pronom personnel|ты
parmi|Il a trouvé un trésor parmi les rochers.|Préposition|среди
malin|Il est malin, toujours en train de trouver des solutions.|Adjectif|хитрый
attaquaient|Les pirates attaquaient le navire avec force.|Verbe|нападали
énergie|Il a beaucoup d'énergie pour jouer au football.|Nom féminin|энергия
intéressé|La science le passionnait, il était vraiment intéressé.|Verbe|интересовал
noir|La nuit, tout est noir et mystérieux.|Adjectif|черный
rigoler|Ils adorent rigoler et s'amuser ensemble.|Verbe|смеяться
où|Où est mon livre ?|Adverbe|где
argent|L'argent ne peut pas acheter le bonheur.|Nom masculin|деньги
parties|Les parties de poker sont toujours amusantes.|Nom féminin|части
servir|Je ne veux m'en servir que plus tard.|Verbe|обслуживать
capitaines|Les capitaines du navire étaient expérimentés.|Nom masculin|капитаны
coule|L'eau coule doucement dans la rivière.|Verbe|течет
cafard|Il a eu un cafard pendant la période d'examens.|Nom masculin|таракан
terribles|Les cris de la tempête étaient terribles.|Adjectif|страшные
agent|L'agent immobilier a aidé à trouver la maison parfaite.|Nom masculin|агент
aime|Elle aime la danse contemporaine.|Verbe|любит
méchants|Les méchants dans les histoires sont souvent les plus intéressants.|Adjectif|злые
défendu|Il a défendu son ami contre les moqueries.|Verbe|защищал
équipes|Les équipes s'affrontent dans un match de football.|Nom féminin|команды
piqué|Il a été piqué par un moustique dans la forêt.|Verbe|укусить
travers|Il a traversé la rue en courant.|Préposition|через
aimé|Le livre qu'elle a aimé est devenu son préféré.|Verbe|понравилось
chevilles|Il a mal aux chevilles après une longue marche.|Nom féminin|лодыжки
boxing|Le boxing est un sport exigeant.|Nom masculin|бокс
tique|Il a retiré la tique de son chien avec précaution.|Nom féminin|клещ
cousine|Sa cousine habite à l'étranger.|Nom féminin|кузина
fichu|La voiture est fichue, il faudra la réparer.|Adjectif|поломанный
revolver|Il a dégainé son revolver pour se défendre.|Nom masculin|револьвер
embêtant|C'est embêtant de perdre ses clés.|Adjectif|надоедливый
diraient|Ils ne diraient pas non à une pizza ce soir.|Verbe|сказали бы
regardant|Il a passé la journée à la plage en regardant les vagues.|Verbe|смотрел
as|Il a un as dans sa manche.|Nom masculin|туз
resterait|Il resterait à la maison s'il faisait mauvais temps.|Verbe|остался бы
heureusement|Heureusement, tout s'est bien passé.|Adverbe|к счастью
fatigué|Il était tellement fatigué après la journée de travail.|Adjectif|усталый
entendre|Il pouvait entendre le chant des oiseaux le matin.|Verbe|слышать
fauteuil|Il s'est installé confortablement dans le fauteuil.|Nom masculin|кресло
manger|Elle a faim et veut manger quelque chose.|Verbe|есть
hurler|Il ne faut pas hurler dans la bibliothèque.|Verbe|кричать
retourna|Il se retourna pour voir qui l'appelait.|Verbe|вернулся
arithmétique|L'arithmétique est une branche des mathématiques.|Nom féminin|арифметика
faim|Elle a une grande faim après sa séance de sport.|Nom féminin|голод
six|Il y a six pommes dans le panier.|Numéral|шесть
minables|Ils ont été traités de minables à l'école.|Adjectif|негодяи
seras|Tu seras bientôt diplômé de l'université.|Verbe|будешь
grattait|Il se grattait la tête en cherchant la réponse.|Verbe|чесал
privé|Il a été privé de dessert pour sa mauvaise conduite.|Adjectif|лишен
placard|Il a rangé ses vêtements dans le placard.|Nom masculin|шкаф
très|Elle est très intelligente et travaille dur.|Adverbe|очень
visite|Il attend une visite de ses amis ce week-end.|Nom féminin|посещение
aimerais|J'aimerais une tasse de thé, s'il vous plaît.|Verbe|хотел бы
sauté|Il a sauté par-dessus la barrière.|Verbe|прыгать
gestes|Ses gestes montrent sa frustration.|Nom masculin|жесты
estrade|Les musiciens sont montés sur l'estrade pour le concert.|Nom féminin|балкон
contente|Elle était contente de voir ses amis après si longtemps.|Adjectif|счастливая
mettant|Il a écrit une lettre en mettant ses sentiments sur papier.|Verbe|поместив
bleu|Le ciel est d'un bleu magnifique aujourd'hui.|Adjectif|голубой
comprendras|Avec de l'effort, tu comprendras les mathématiques.|Verbe|поймешь
courses|Elle a fait les courses pour acheter des provisions.|Nom féminin|покупки
risquaient|Ils risquaient leur vie pour sauver l'enfant.|Verbe|рисковали
perdait|Il perdait toujours ses clés.|Verbe|терял
font|Les abeilles font du miel.|Verbe|делают
quand|Quand viendras-tu me rendre visite ?|Conjonction|когда
places|Il a acheté des places pour le concert de son groupe préféré.|Nom féminin|места
bracelet|Le bracelet était un cadeau précieux de sa grand-mère.|Nom masculin|браслет
animaux|Les enfants adorent les animaux de compagnie.|Nom masculin|животное
prendra|Il prendra une pause bien méritée après le travail.|Verbe|возьмет
nos|Nos amis viendront nous rendre visite ce week-end.|Pronom possessif|наши
malade|Elle est malade et doit rester au lit.|Adjectif|больная
finirions|Nous finirions ce projet plus tôt sans les interruptions.|Verbe|закончили бы
dévisser|Il a dû dévisser les écrous pour réparer la chaise.|Verbe|открутить
masque|Il portait un masque effrayant pour Halloween.|Nom masculin|маска
pâle|Elle est devenue pâle en entendant la mauvaise nouvelle.|Adjectif|бледный
cahiers|Les cahiers sont prêts pour la rentrée scolaire.|Nom masculin|тетради
arrivé|Il est arrivé en retard à la réunion.|Verbe|приехал
élémentaire|Les mathématiques élémentaires sont importantes.|Adjectif|элементарный
repas|Le repas du soir est prêt à être servi.|Nom masculin|еда
confisque|La police confisque les biens volés.|Verbe|конфисковывает
cartouches|Il a acheté des cartouches pour son imprimante.|Nom féminin|картриджи
mètres|Il a nagé plusieurs mètres sous l'eau.|Nom masculin|метры
dépense|Il tient un registre de ses dépenses mensuelles.|Nom féminin|расходы
léché|Le chien a léché le visage de son propriétaire.|Verbe|лизал
vitre|La vitre de la fenêtre est cassée.|Nom féminin|стекло
continuez|Continuez à travailler dur pour atteindre vos objectifs.|Verbe|продолжайте
servaient|Les serviettes servaient à essuyer les mains.|Verbe|использовались
séparer|Il a dû séparer les deux chiens qui se battaient.|Verbe|разделять
levés|Ils se sont levés tôt pour profiter de la journée.|Verbe|поднимались
reviendra|Il a promis qu'il reviendra bientôt.|Verbe|вернется
mangeant|Elle a été prise en photo en mangeant une glace.|Verbe|едя
panier|Il a trouvé des œufs dans le panier de Pâques.|Nom masculin|корзина
terminée|La journée de travail est enfin terminée.|Adjectif|завершена
arrangeait|Il arrangeait les fleurs dans un vase.|Verbe|украшал
criaient|Les enfants étaient excités et criaient de joie.|Verbe|кричали
ses|Elle a oublié ses clés à la maison.|Pronom possessif|ее
sûrement|Elle trouvera sûrement une solution à ce problème.|Adverbe|наверняка
électrique|Le train électrique circule autour de l'arbre de Noël.|Adjectif|электрический
malgré|Malgré les obstacles, elle a réussi.|Préposition|несмотря на
tranquilles|Les soirées tranquilles à la maison sont agréables.|Adjectif|спокойные
ramassée|La neige ramassée sur le sol scintillait au soleil.|Adjectif|накопленный
coin|Il a trouvé un trésor caché dans un coin du jardin.|Nom masculin|угол
mâchant|Il marchait en mâchant un chewing-gum.|Verbe|жевал
centimes|Il a économisé des centimes dans une tirelire.|Numéral|сотни
tordue|La route était sinueuse et tordue.|Adjectif|изогнутая
douille|Il a utilisé une douille pour visser l'ampoule.|Nom féminin|гаечный ключ
vagues|Les vagues de l'océan sont impressionnantes.|Nom féminin|волны
mêles|Ne te mêles pas des affaires des autres.|Verbe|вмешивайся
nuit|La nuit est paisible avec un ciel étoilé.|Nom féminin|ночь
volaille|Elle a acheté de la volaille pour le dîner de Noël.|Nom féminin|домашняя птица
pauvre|Il a donné de l'argent au pauvre sans abri.|Adjectif|бедный
pied|Il a mal au pied après une longue marche.|Nom masculin|нога
contre|Ils sont en compétition les uns contre les autres.|Préposition|против
jouer|Les enfants aiment jouer dans le jardin.|Verbe|играть
carnet|Il a noté son rendez-vous dans son carnet.|Nom masculin|блокнот
rentre|Il rentre chez lui après une longue journée de travail.|Verbe|идет домой
bure|Le bureau est en désordre après une journée de travail.|Nom masculin|офис
revoir|Il était heureux de revoir ses amis d'enfance.|Verbe|увидеть снова
éclaboussée|L'eau s'est éclaboussée partout pendant le bain.|Verbe|брызги
locomotive|La locomotive tire les wagons sur la voie ferrée.|Nom féminin|локомотив
comment|Comment vas-tu aujourd'hui ?|Adverbe|как
fermier|Le fermier cultive des légumes dans son champ.|Nom masculin|фермер
finalement|Finalement, il a accepté l'offre d'emploi.|Adverbe|наконец
écrites|Les lettres étaient écrites avec une belle calligraphie.|Adjectif|написанные
grinçait|La vieille porte grinçait quand elle s'ouvrait.|Verbe|скрипучий
sorti|Il est sorti pour prendre l'air frais.|Verbe|вышел
peuh|Il a dit "peuh" en buvant le jus de légumes.|Interjection|фу
jambe|Il a mal à la jambe après la course.|Nom féminin|нога
sortis|Ils sont sortis pour faire une promenade dans le parc.|Verbe|вышли
chose|La chose la plus importante est d'être heureux.|Nom féminin|вещь
plusieurs|Il a visité plusieurs pays pendant son voyage.|Pronom indéfini|несколько
revanche|Il voulait prendre sa revanche au jeu d'échecs.|Nom féminin|реванш
france|La France est célèbre pour sa cuisine délicieuse.|Nom propre|Франция
sonné|La cloche a sonné pour marquer la fin de la journée d'école.|Verbe|звонил
gardiens|Les gardiens du zoo s'occupent bien des animaux.|Nom masculin|сторожи
poser|Il a pris une pause pour se poser quelques instants.|Verbe|поставить
aussi|Il est intelligent, mais elle l'est aussi.|Adverbe|тоже
lèverai|Demain matin, je me lèverai tôt pour le travail.|Verbe|поднимусь
injuste|Il trouvait que la décision était injuste.|Adjectif|несправедливый
asseyez|Asseyez-vous confortablement et profitez du spectacle.|Verbe|садитесь
conserves|Les conserves sont une bonne option pour la nourriture à emporter.|Nom féminin|консервы
jambon|Le sandwich au jambon est son préféré.|Nom masculin|ветчина
blagues|Il raconte toujours des blagues pour faire rire les autres.|Nom féminin|шутки
facile|Les mathématiques sont faciles pour lui.|Adjectif|легкие
foire|La foire a attiré de nombreuses familles.|Nom féminin|ярмарка
continuait|Il continuait à jouer de la musique toute la nuit.|Verbe|продолжал
rasé|Il s'est rasé la barbe pour un look plus propre.|Adjectif|побрит
déguisé|Il s'est déguisé en super-héros pour Halloween.|Verbe|переоделся
dîner|Le dîner était délicieux, merci pour le repas.|Nom masculin|ужин
lu|Elle a lu tous les livres de la bibliothèque.|Verbe|читала
mauvais|Il avait un mauvais pressentiment à ce sujet.|Adjectif|плохой
passais|Je passais devant chez toi en voiture hier.|Verbe|проезжал
rigolait|Elle rigolait aux blagues de son ami.|Verbe|смеялась
sanglant|Le film d'action était plein de scènes sanglantes.|Adjectif|кровавый
onsieur|Il a salué le monsieur avec un sourire.|Nom masculin|господин
bagne|Il a été envoyé au bagne pour ses crimes.|Nom masculin|каторга
éperons|Les éperons sont utilisés pour monter à cheval.|Nom masculin|шпоры
hasard|Le hasard a joué un rôle dans leur rencontre.|Nom masculin|случай
pains|Les pains frais sortent du four chaque matin.|Nom masculin|хлебы
auront|Ils auront bientôt terminé le projet.|Verbe|будут иметь
peu|Il reste peu de temps avant le départ.|Adverbe|немного
pleurer|Les enfants peuvent pleurer quand ils sont tristes.|Verbe|плакать
guidon|Il tenait fermement le guidon de son vélo.|Nom masculin|руль
verbe|Le verbe "aimer" est souvent utilisé en poésie.|Nom masculin|глагол
prise|La prise électrique est à côté de la table.|Nom féminin|розетка
mon|Mon ami est venu me rendre visite hier.|Pronom possessif|мой
mariera|Elle se mariera l'année prochaine.|Verbe|выйдет замуж
interrogé|Il a été interrogé par la police après le vol.|Verbe|допрошен
expériences|Il a mené des expériences pour sa thèse de doctorat.|Nom féminin|опыты
plainte|Il a déposé une plainte auprès de la direction de l'école.|Nom féminin|жалоба
emmènerait|Il l'emmènerait en voyage autour du monde.|Verbe|отвез бы
autos|Les autos sont garées dans le parking souterrain.|Nom masculin|автомобили
nia|Il nia toute implication dans l'affaire.|Verbe|отрицал
oreille|Il avait mal à l'oreille après le concert bruyant.|Nom féminin|ухо
sures|Les réponses étaient sures et correctes.|Adjectif|уверенные
gâchis|La tempête a causé un gâchis dans le jardin.|Nom masculin|путаница
ramenait|Il ramenait des souvenirs de son voyage en Asie.|Verbe|привозил
allions|Nous allions souvent à la plage pendant les vacances d'été.|Verbe|ходили
signe|Il a fait un signe de la main pour dire au revoir.|Nom masculin|жест
eu|Il a eu une excellente idée pour le projet.|Verbe|получил
tabac|Il n'a jamais fumé de tabac de sa vie.|Nom masculin|табак
coucher|Il est temps d'aller se coucher pour être en forme demain.|Verbe|ложиться спать
mordant|Le chien a un mordant fort pour tenir ses jouets.|Adjectif|кусачий
marié|Il s'est marié avec son amour de jeunesse.|Adjectif|женат
te|Je te verrai demain à la fête d'anniversaire.|Pronom personnel|тебя
cuisse|La cuisse de poulet était délicieuse.|Nom féminin|бедро
détacher|Il devait détacher les nœuds pour ouvrir la boîte.|Verbe|развязать
restaient|Les amis restaient tard pour discuter.|Verbe|оставались
silence|Le silence régnait dans la bibliothèque.|Nom masculin|тишина
cherches|Que cherches-tu dans ce tiroir ?|Verbe|ищешь
huit|Il a huit ans aujourd'hui, c'est son anniversaire.|Numéral|восемь
gentiment|Elle a répondu gentiment à toutes les questions.|Adverbe|доброжелательно
devait|Il devait prendre une décision importante.|Verbe|должен
chance|Il a eu de la chance de gagner à la loterie.|Nom féminin|удача
tourne|Il tourne la clé pour allumer la voiture.|Verbe|поворачивает
cacher|Il a dû se cacher pour éviter d'être vu.|Verbe|прятаться
première|Elle a remporté la première place à la course.|Nom féminin|первое
presque|Il est presque temps de partir.|Adverbe|почти
proclamé|Il a proclamé son amour à haute voix.|Verbe|провозгласил
séparé|Ils se sont séparés après une dispute.|Adjectif|разделенный
multimillionnaire|Il est devenu multimillionnaire grâce à son entreprise.|Nom masculin|мультимиллионер
haie|La haie de buis est taillée avec précision.|Nom féminin|живая изгородь
conserve|Elle conserve des souvenirs précieux dans une boîte.|Verbe|сохраняет
croupi|L'eau stagnante était croupie et malodorante.|Adjectif|застойный
allés|Ils sont allés au cinéma pour voir un film.|Verbe|пошли
ni|Ni lui ni elle n'ont pu résoudre l'énigme.|Conjonction|ни
toujours|Il est toujours de bonne humeur le matin.|Adverbe|всегда
intéresser|Ce livre pourrait vous intéresser.|Verbe|интересовать
travaillait|Il travaillait dur pour subvenir aux besoins de sa famille.|Verbe|работал
faisons|Faisons une promenade dans le parc cet après-midi.|Verbe|делаем
bravo|Bravo pour avoir réussi l'examen !|Interjection|молодец
apprennent|Les enfants apprennent de nouvelles choses à l'école.|Verbe|учатся
blanc|Le cygne est un bel oiseau blanc.|Adjectif|белый
fini|Il a enfin fini de lire ce gros livre.|Adjectif|закончил
francs|Il a payé cinquante francs pour le dîner.|Nom masculin|франков
couru|Il a couru un marathon l'année dernière.|Verbe|бежал
cherchait|Elle cherchait son téléphone partout dans la maison.|Verbe|ищет
retourné|Il s'est retourné pour voir qui l'appelait.|Verbe|вернулся
autobus|L'autobus est en retard à cause des embouteillages.|Nom masculin|автобус
guerre|La guerre a eu des conséquences dévastatrices.|Nom féminin|война
absolument|Il est absolument sûr de ses compétences.|Adverbe|абсолютно
déranger|À chaque instant, il fallait déranger le plombier.|Verbe|беспокоить
longue|Elle portait une robe longue pour la soirée.|Adjectif|длинное
fleurs|Les fleurs dans le jardin sont magnifiques.|Nom féminin|цветы
tard|Il est rentré à la maison plus tard que d'habitude.|Adverbe|поздно
jacques|Jacques est un prénom courant en France.|Nom propre|Жак
fables|Les fables d'Ésope sont pleines de sagesse.|Nom féminin|басни
glissé|Il a glissé sur la glace et est tombé.|Verbe|поскользнулся
sages|Les sages conseillers du roi l'ont aidé à prendre une décision.|Adjectif|мудрые
pardon|Elle a demandé pardon pour son erreur.|Interjection|простите
fatiguée|Elle était fatiguée après une longue journée de travail.|Adjectif|уставшая
viendront|Ils viendront rendre visite ce week-end.|Verbe|придут
avalé|Il a avalé la pilule avec de l'eau.|Verbe|проглотил
permettez|Permettez-moi de vous présenter mon ami.|Verbe|позвольте
jetaient|Ils jetaient des cailloux dans l'eau.|Verbe|бросали
retrouve|Elle retrouve toujours son chemin grâce à son sens de l'orientation.|Verbe|находит
voulaient|Ils voulaient acheter une nouvelle voiture.|Verbe|хотели
dresser|Elle a utilisé une étagère pour dresser ses livres dans sa chambre.|Verbe|дрессировал
trouva|Elle trouva un trésor caché dans le sable.|Verbe|нашла
seulement|Il était le seul à comprendre la situation, seulement lui.|Adverbe|только
comprends|Je comprends parfaitement ce que vous dites.|Verbe|понимаю
avec|Elle est venue avec son ami.|Préposition|с
cadeau|Le cadeau était emballé dans un joli papier coloré.|Nom masculin|подарок
ordre|Il a suivi l'ordre de son supérieur.|Nom masculin|порядок
enverrait|Il enverrait un e-mail pour confirmer sa présence.|Verbe|отправил бы
gloire|La gloire est souvent éphémère dans le monde du divertissement.|Nom féminin|слава
rude|Le travail manuel peut être rude pour le corps.|Adjectif|тяжелый
rentré|Il est rentré chez lui après une longue journée de travail.|Verbe|вернулся
photo|La photo montre un magnifique coucher de soleil.|Nom féminin|фотография
danser|Ils aiment danser ensemble lors des soirées.|Verbe|танцевать
croirait|On ne le croirait jamais, mais c'est la vérité.|Verbe|поверил бы
ressort|Le ressort du stylo est cassé.|Nom masculin|пружина
voudre|Je voudre commander une pizza pour la livraison.|Verbe|хочу
morceaux|Il a coupé les légumes en petits morceaux.|Nom masculin|куски
être|Il vaut mieux être préparé pour l'entretien d'embauche.|Verbe|быть
cheville|Elle s'est foulé la cheville en jouant au football.|Nom féminin|лодыжка
amateur|Il est un amateur de musique classique.|Nom masculin|любитель
discipline|La discipline est importante pour le succès académique.|Nom féminin|дисциплина
poitrine|Elle a ressenti une douleur à la poitrine.|Nom féminin|грудь
velours|Le canapé est recouvert de velours doux.|Nom masculin|бархат
théâtres|Les amateurs de culture fréquentent souvent les théâtres pour assister à des représentations artistiques.|Nom masculin|театры
plis|Le linge est plein de plis après le lavage.|Nom masculin|складки
entrer|Il a dû montrer son badge pour entrer dans le bâtiment.|Verbe|войти
murs|Les murs de la maison ont besoin d'être repeints.|Nom masculin|стены
acrobaties|Les acrobaties des artistes de cirque sont impressionnantes.|Nom féminin|акробатика
crié|Il a crié pour attirer l'attention des passants.|Verbe|кричал
quel|Quel livre préférez-vous parmi ceux-ci ?|Pronom interrogatif|какой
manqué|Il a manqué la réunion à cause d'un problème de transport.|Verbe|пропустил
restes|Les restes du repas ont été mis au réfrigérateur.|Nom masculin|остатки
ramène|Il ramène toujours des souvenirs de ses voyages.|Verbe|привозит
ressorts|Les ressorts du matelas assurent un bon soutien.|Nom masculin|пружины
droite|Tournez à droite au prochain carrefour.|Adjectif|право
passés|Les souvenirs des jours passés restent gravés dans notre mémoire.|Verbe|провели
jouait|Il jouait du piano avec talent.|Verbe|играл
retenu|Il a retenu l'information importante.|Verbe|запомнил
écrire|Elle aime écrire des poèmes et des histoires.|Verbe|писать
aspirait|Il aspirait à devenir un grand artiste.|Verbe|стремился
prêté|Elle a prêté son vélo à son ami pour la journée.|Verbe|одолжила
soleil|Le soleil brille fort pendant l'été.|Nom masculin|солнце
goûter|Le goûter est prêt dans la cuisine.|Nom masculin|полдник
sales|Les chaussures étaient sales après la randonnée dans la boue.|Adjectif|грязные
surveillant|Le surveillant s'assure que les élèves suivent les règles.|Nom masculin|надзиратель
dirai|Je te dirai la vérité, quelle qu'elle soit.|Verbe|скажу
sort|Il sort faire du vélo tous les dimanches.|Verbe|выходит
vait|Il vait une grande passion pour l'astronomie.|Verbe|имел
pavés|Les pavés de la vieille ville sont charmants.|Nom masculin|булыжники
entendu|Il a entendu une étrange rumeur dans la nuit.|Verbe|слышал
surveilleras|Tu surveilleras la cuisine pendant que je prépare le dîner.|Verbe|будешь следить
ressemblaient|Les jumeaux se ressemblaient comme deux gouttes d'eau.|Verbe|были похожи
installés|Ils se sont installés confortablement sur le canapé.|Verbe|уселись
chats|Les chats aiment se prélasser au soleil.|Nom masculin|коты
fromage|Le fromage est une spécialité française délicieuse.|Nom masculin|сыр
tiré|Il a tiré sur la corde pour faire sonner la cloche.|Verbe|тянул
taureau|Le taureau est un symbole de force et de courage.|Nom masculin|бык
rencontré|Il a rencontré sa future femme à l'université.|Verbe|встретил
troisième|Elle est arrivée en troisième position lors de la course.|Numéral|третий
débroui|Il s'est débrouillé pour réparer la voiture lui-même.|Verbe|справился
continuais|Je continuais à travailler même tard le soir.|Verbe|продолжал
désire|Elle désire voyager et découvrir de nouveaux endroits.|Verbe|желает
centres|Les centres commerciaux sont populaires le week-end.|Nom masculin|центры
gauche|Tournez à gauche au feu tricolore.|Adjectif|налево
pensé|Elle a pensé à une solution créative au problème.|Verbe|подумала
noire|La nuit était noire et silencieuse.|Adjectif|черная
derrière|Il a couru pour attraper le bus qui partait derrière lui.|Préposition|сзади
cuir|Le canapé en cuir est élégant et confortable.|Nom masculin|кожа
compliquée|La tâche était plus compliquée qu'elle ne le pensait.|Adjectif|сложная
sourd|Le musicien sourd a développé un talent extraordinaire pour la création de musique malgré son handicap auditif.|Adjectif|глухой
lâchait|Il ne lâchait pas la main de son enfant dans la foule.|Verbe|отпускал
alors|Il était alors temps de prendre une décision.|Adverbe|тогда
désigné|Il a été désigné comme le chef de projet.|Adjectif|назначен
cave|La cave est un endroit idéal pour stocker le vin.|Nom féminin|подвал
serai|Je serai là à l'heure convenue.|Verbe|буду
fumer|Il a l'habitude de fumer une cigarette après le dîner.|Verbe|курить
joue|Il a une balle dans la main et un sourire sur la joue.|Nom féminin|щека
tours|Ils font des tours de magie incroyables.|Nom masculin|тур
gratter|Le chat aime se gratter derrière les oreilles.|Verbe|чесать
adorable|Le chiot est tellement adorable.|Adjectif|очаровательный
noeuds|Elle a attaché les lacets en deux noeuds.|Nom masculin|узлы
nom|Son nom est gravé sur la plaque.|Nom masculin|имя
essuyait|Elle essuyait la table après le dîner.|Verbe|вытирала
veines|Les veines transportent le sang dans tout le corps.|Nom féminin|вены
bouts|Les bouts de papier sont éparpillés sur le sol.|Nom masculin|концы
roulé|Il a roulé le tapis pour le nettoyer.|Adjectif|свернутый
laisser|Il ne faut pas laisser la porte ouverte.|Verbe|оставлять
coulent|Les rivières coulent vers la mer.|Verbe|течь
atteignent|Ils atteignent leurs objectifs avec persévérance.|Verbe|достигают
confiture|La confiture de fraises est délicieuse sur des crêpes.|Nom féminin|варенье
briquet|Il a allumé une cigarette avec un briquet.|Nom masculin|зажигалка
courir|Il aime courir le matin pour rester en forme.|Verbe|бежать
mordu|Il a été mordu par un chien enragé.|Verbe|укусил
je|Je suis très content de vous voir.|Pronom personnel|я
écrasée|La boîte a été écrasée sous le poids de la voiture.|Adjectif|раздавленный
criait|Il criait de douleur après s'être blessé.|Verbe|кричал
grands|Les grands arbres fournissent de l'ombre en été.|Adjectif|большие
rouge|Elle a mis un joli rouge à lèvres.|Adjectif|красный
peut|Il peut résoudre ce problème rapidement.|Verbe|может
laisse|Elle laisse toujours une pièce de chocolat pour moi.|Verbe|оставляет
question|Posez-moi n'importe quelle question.|Nom féminin|вопрос
commence|Le spectacle commence à 19 heures précises.|Verbe|начинается
habitué|Il est habitué à travailler tard le soir.|Adjectif|привыкший
descendu|Il est descendu de l'escalier en courant.|Verbe|спустился
élevé|Il a été élevé dans un petit village.|Adjectif|воспитанный
pépé|Son pépé lui a raconté des histoires passionnantes.|Nom masculin|дедушка
visiter|Elle aime visiter de nouveaux endroits pendant les vacances.|Verbe|посещать
cela|Cela semble être une bonne idée.|Pronom|это
près|La boulangerie est près de la gare.|Adverbe|близко
roues|Les roues de la bicyclette tournent rapidement.|Nom féminin|колеса
rire|Son rire était contagieux, tout le monde a ri.|Verbe|смеяться
fâché|Il était fâché contre son collègue pour l'avoir trahi.|Adjectif|злой
appris|Elle a appris à jouer du piano à un jeune âge.|Verbe|училась
maisons|Les maisons du quartier sont très colorées.|Nom féminin|дома
ferait|Il ferait n'importe quoi pour aider ses amis.|Verbe|сделал бы
enveloppé|Le cadeau est joliment enveloppé dans du papier cadeau.|Adjectif|завернутый
pend|Il a pendu les rideaux dans le salon.|Verbe|повесил
emmené|Il a emmené son chien au parc pour une promenade.|Verbe|взял с собой
garçon|Le petit garçon joue dans le jardin.|Nom masculin|мальчик
roulait|La voiture roulait rapidement sur l'autoroute.|Verbe|ехала
joli|Elle porte une robe jolie et colorée.|Adjectif|красивый
notes|Il a pris des notes pendant la réunion.|Nom masculin|заметки
caramels|Les caramels sont une délicieuse friandise.|Nom masculin|карамель
psychologie|L'étude de la psychologie est fascinante.|Nom féminin|психология
ils|Ils sont venus nous rendre visite hier.|Pronom personnel|они
embêté|Il était embêté par les moustiques pendant la nuit.|Adjectif|раздраженный
marche|La marche est un excellent exercice pour la santé.|Nom féminin|ходьба
retard|Il est en retard à cause des embouteillages.|Nom masculin|задержка
tourna|Il tourna la clé pour allumer la voiture.|Verbe|повернул
grande|Elle a une grande maison près de la plage.|Adjectif|большой
interroge|Il interroge les témoins pour obtenir des informations.|Verbe|допрашивает
jours|Les jours de la semaine passent très vite.|Nom masculin|дни
bêta|Il participe à l'essai bêta de la nouvelle application.|Adjectif|бета
boue|Il a glissé dans la boue après la pluie.|Nom féminin|грязь
ayons|Ayons une réunion pour discuter de ce projet.|Verbe|имейте
servi|Elle a servi le dîner à ses invités.|Verbe|подал
vitrine|Les bijoux sont exposés dans la vitrine.|Nom féminin|витрина
pays|Son pays d'origine est la France.|Nom masculin|страна
appelez|Appelez-moi si vous avez des questions.|Verbe|позвоните
rentrer|Il est temps de rentrer à la maison.|Verbe|идти домой
eau|L'eau est essentielle à la vie sur Terre.|Nom féminin|вода
cassé|Le vase en porcelaine s'est cassé en tombant.|Adjectif|сломанный
occuper|Il aime s'occuper de son jardin le week-end.|Verbe|заниматься
toi|Je pense à toi tous les jours.|Pronom personnel|ты
boude|Il boude parce qu'il n'a pas obtenu ce qu'il voulait.|Verbe|сердится
coyote|Le coyote est un animal sauvage et intelligent.|Nom masculin|коют
appliqué|Il est un étudiant appliqué et sérieux.|Adjectif|прилежный
lisions|Nous lisions un livre passionnant.|Verbe|читали
jeudi|Le jeudi est le jour de la réunion d'équipe.|Nom masculin|четверг
sommes|Nous sommes en train de préparer un gâteau délicieux.|Verbe|находимся
compliqué|Les mathématiques peuvent être compliquées.|Adjectif|сложный
contraventions|Les contraventions de stationnement doivent être payées.|Nom féminin|нарушения
risque|Le saut en parachute comporte un certain risque.|Nom masculin|риск
gymnastique|La gymnastique rythmique est un sport artistique.|Nom féminin|гимнастика
mauvaises|Les mauvaises habitudes sont difficiles à briser.|Adjectif|плохие
appeler|N'hésitez pas à m'appeler si vous avez besoin d'aide.|Verbe|звонить
tiendrait|Il tiendrait sa promesse de ne jamais mentir.|Verbe|держал бы
peux|Je peux t'aider à résoudre ce problème.|Verbe|могу
étudier|Il prévoit d'étudier la médecine à l'université.|Verbe|изучать
préparer|Elle aime préparer des plats délicieux pour sa famille.|Verbe|готовить
avoir|J'aimerais avoir plus de temps pour voyager.|Verbe|иметь
cassés|Les jouets cassés ont été jetés à la poubelle.|Adjectif|сломанные
chouet|La chouette est un oiseau nocturne.|Nom féminin|сова
triché|Il a triché lors du jeu de cartes.|Verbe|жульничал
natation|La natation est un excellent exercice pour tout le corps.|Nom féminin|плавание
réuni|Ils se sont réunis pour célébrer le mariage.|Verbe|собрались
appellera|Il vous appellera dès qu'il aura le résultat.|Verbe|позвонит
aurai|J'aurai besoin de ton aide demain matin.|Verbe|буду иметь
pantalon|Il porte un pantalon élégant et une chemise blanche.|Nom masculin|брюки
salis|Les vêtements sont salis après une journée de travaux.|Adjectif|грязные
bonbons|Les bonbons sont une délicieuse friandise.|Nom masculin|конфеты
rasoir|Il a utilisé un rasoir pour se raser le visage.|Nom masculin|бритва
légumes|Les légumes frais sont essentiels pour une alimentation saine.|Nom masculin|овощи
autant|Elle mange autant qu'un champion après l'entraînement.|Adverbe|столько
faites|Faites de votre mieux dans tout ce que vous entreprenez.|Verbe|делайте
ancien|Le château est un bâtiment ancien et historique.|Adjectif|старый
mélangeaient|Ils mélangeaient différentes couleurs pour créer une nouvelle teinte.|Verbe|смешивали
courais|Je courais tous les matins pour rester en forme.|Verbe|бегал
toussé|Il a toussé plusieurs fois à cause du rhume.|Verbe|кашлял
avais|J'avais oublié d'acheter du pain.|Verbe|имел
factures|Les factures doivent être payées à temps.|Nom féminin|счета
ciel|Le ciel étoilé est magnifique la nuit.|Nom masculin|небо
disant|Elle a quitté la pièce en disant au revoir à tous.|Verbe|говоря
croissant|Il a mangé un croissant pour le petit-déjeuner.|Nom masculin|круассан
deux|Ils ont deux enfants, un garçon et une fille.|Numéral|два
pyjama|Elle porte son pyjama préféré pour dormir.|Nom masculin|пижама
sandwichs|Les sandwichs au thon sont délicieux pour le déjeuner.|Nom masculin|бутерброды
dissipez|Dissipez les doutes et soyez confiant en vos capacités.|Verbe|развеивайте
attaquer|Ils ont décidé d'attaquer la montagne en escalade.|Verbe|атаковать
écartée|La porte était écartée, laissant entrer la lumière du soleil.|Adjectif|раздвинутая
aimait|Elle aimait les roses rouges comme cadeau.|Verbe|любила
autres|Les autres invités sont déjà arrivés à la fête.|Adjectif|другие
entendions|Nous entendions le chant des oiseaux au réveil.|Verbe|слышали
chante|Elle chante très bien et a une belle voix.|Verbe|поет
écrasé|Le papier a été écrasé sous le poids des livres.|Adjectif|раздавленный
jamais|Il ne se rendra jamais sans se battre.|Adverbe|никогда
arrivera|Tout finira bien, cela arrivera bientôt.|Verbe|произойдет
regardaient|Ils regardaient un film passionnant ensemble.|Verbe|смотрели
chercher|Il faut chercher les clés avant de partir.|Verbe|искать
accueil|Il a reçu un accueil chaleureux à la conférence.|Nom masculin|прием
pourrait|Elle pourrait devenir une grande artiste un jour.|Verbe|могла бы
passes|Il y a trois passes pour le parc d'attractions.|Nom féminin|проходы
seuls|Ils aiment passer du temps seuls dans la nature.|Adjectif|одни
défaite|La défaite dans le match était difficile à accepter.|Nom féminin|поражение
cogné|Il a cogné à la porte pour annoncer son arrivée.|Verbe|стучал
souffle|Il a perdu son souffle après la course.|Nom masculin|дыхание
passe|Elle a montré sa carte de membre pour passer.|Verbe|проходит
issez|Laissez-moi faire ce que je dois faire, s'il vous plaît.|Verbe|позвольте
venu|Il est venu nous rendre visite ce week-end.|Verbe|пришел
oseront|Ils oseront tout pour réaliser leurs rêves.|Verbe|осмелятся
cellule|La cellule est la plus petite unité de vie.|Nom féminin|клетка
en|Il est en train de lire un livre intéressant.|Préposition|в
changiez|Si vous changiez d'avis, faites-le moi savoir.|Verbe|меняли
obligés|Nous étions obligés de prendre une décision rapidement.|Adjectif|обязанны
mer|La mer est belle en été, avec ses vagues douces.|Nom féminin|море
côté|Elle marchait du côté ensoleillé de la rue.|Nom masculin|сторона
espèce|Cette espèce d'oiseau est en voie de disparition.|Nom féminin|вид
lettres|Les lettres d'amour étaient remplies de passion.|Nom féminin|письма
avanceraient|Ils avanceraient leurs pions sur l'échiquier.|Verbe|двигались
année|L'année prochaine, je prévois de voyager davantage.|Nom féminin|год
faudra|Il faudra du temps pour guérir de cette blessure.|Verbe|понадобится
biscuit|Les biscuits faits maison sont délicieux avec du thé.|Nom masculin|печенье
sortir|Ils aiment sortir dîner le samedi soir.|Verbe|выходить
user|Le temps peut user les vieilles photos.|Verbe|изнашивать
fermer|N'oublie pas de fermer la porte à clé en partant.|Verbe|закрыть
portes|Les portes du musée s'ouvrent à 10 heures.|Nom féminin|двери
debout|Il était debout devant la foule en parlant.|Adverbe|стоя
marchez|Vous marchez d'un pas sûr et confiant.|Verbe|идете
passer|Il est temps de passer à l'action.|Verbe|перейти
vraiment|Elle est vraiment une personne gentille.|Adverbe|действительно
regretterait|Il regretterait ses paroles offensantes plus tard.|Verbe|пожалел бы
roue|Les enfants aiment tourner la roue du manège.|Nom féminin|колесо
vu|Il a vu un film passionnant au cinéma.|Verbe|видел
mairie|La mairie est l'endroit où l'on peut obtenir un permis de construire.|Nom féminin|мэрия
idées|Elles partagent des idées créatives pour le projet.|Nom féminin|идеи
ensemble|Ils chantent ensemble dans la chorale de l'église.|Adverbe|вместе
dernière|La dernière page du livre était très émouvante.|Adjectif|последний
jouets|Les enfants ont beaucoup de jouets dans leur chambre.|Nom masculin|игрушки
prisonnier|Il a été fait prisonnier pendant la guerre.|Nom masculin|заключенный
dessinais|Je dessinais un joli paysage dans mon cahier.|Verbe|рисовал
chaud|Il fait très chaud en été.|Adjectif|жарко
cracher|Il ne devrait pas cracher par terre, c'est impoli.|Verbe|плевать
joueur|Il est un joueur talentueux de l'équipe de football.|Nom masculin|игрок
cuit|Le poulet était parfaitement cuit.|Adjectif|приготовленный
georges|Georges est un prénom très commun en France.|Nom propre|Жорж
mentir|Il ne faut pas mentir, c'est malhonnête.|Verbe|лгать
route|La route était longue et sinueuse.|Nom féminin|дорога
calme|Elle était calme malgré la situation stressante.|Adjectif|спокойный
enragé|Le chien enragé a été mis en quarantaine.|Adjectif|бешеный
genre|Quel genre de musique préférez-vous ?|Nom masculin|род
acheté|Elle a acheté de nouveaux vêtements pour l'été.|Verbe|купил
wagons|Les wagons du train étaient bondés.|Nom masculin|вагоны
peau|Elle a une peau douce et soyeuse.|Nom féminin|кожа
tienne|Cette maison est la tienne, n'est-ce pas ?|Adjectif possessif|твой
shérif|Le shérif était chargé de maintenir l'ordre dans la ville.|Nom masculin|шериф
avait|Il avait un livre passionnant à lire.|Verbe|имел
reviendrai|Je reviendrai te chercher plus tard.|Verbe|вернусь
combien|Combien coûte ce billet de train ?|Adverbe interrogatif|сколько
trouve|Elle trouve toujours le temps de méditer.|Verbe|находит
miroir|Le miroir reflète ton image.|Nom masculin|зеркало
aiment|Ils aiment passer du temps en plein air.|Verbe|любят
tour|Il a fait un tour en vélo dans le parc.|Nom masculin|тур
lécher|Le chien aime lécher les visages de ses propriétaires.|Verbe|лизать
travailler|Il doit travailler dur pour atteindre ses objectifs.|Verbe|работать
flous|Les souvenirs d'enfance sont souvent flous.|Adjectif|размытые
marque|Cette marque de vêtements est très populaire.|Nom féminin|марка
ficelle|La ficelle était utilisée pour attacher les paquets.|Nom féminin|веревка
achèterai|J'achèterai des fruits au marché demain.|Verbe|куплю
eux|Ils sont venus avec eux à la fête.|Pronom personnel|они
quitterais|Je quitterais ce travail s'il n'était pas satisfaisant.|Verbe|покинул бы
agiteront|Ils agiteront les drapeaux lors de la cérémonie.|Verbe|поднимут
infirmerie|L'infirmerie de l'école était bien équipée.|Nom féminin|инфирмария
demander|N'hésitez pas à demander de l'aide si vous en avez besoin.|Verbe|спрашивать
wagon|Le wagon du train était confortable.|Nom masculin|вагон
épices|Les épices ajoutent de la saveur à la cuisine.|Nom féminin|специи
pitre|Le pitre de la classe faisait rire tout le monde.|Nom masculin|шутник
raconté|Il a raconté une histoire intéressante à ses amis.|Verbe|рассказал
couleur|Elle a choisi une couleur vive pour sa robe.|Nom féminin|цвет
rangs|Les élèves se sont alignés en rangs pour la récréation.|Nom masculin|ряды
bandits|Les bandits ont été arrêtés par la police.|Nom masculin|бандиты
monte|Il monte à cheval tous les week-ends.|Verbe|седлает
instructives|Les leçons d'histoire étaient très instructives.|Adjectif|поучительные
appelé|Il a appelé son ami pour lui donner des nouvelles.|Verbe|позвал
piscine|La piscine est l'endroit idéal pour se rafraîchir en été.|Nom féminin|бассейн
cheveux|Elle a de beaux cheveux longs et soyeux.|Nom masculin|волосы
feuilles|Les feuilles d'automne tombent des arbres.|Nom féminin|листья
incroyable|C'était une expérience incroyable que de grimper cette montagne.|Adjectif|невероятный
cartables|Les cartables des élèves étaient lourds de livres.|Nom masculin|рюкзаки
racler|Il a utilisé une pelle pour racler la neige du trottoir.|Verbe|чистить
notre|Notre maison est située près du lac.|Pronom possessif|наш
étranger|Voyager à l'étranger élargit vos horizons.|Nom masculin|иностранец
fais|Je fais du vélo tous les matins pour rester en forme.|Verbe|делаю
devenue|Elle est devenue une célèbre actrice de cinéma.|Verbe|стала
coura|Elle courait vite pour attraper le bus.|Verbe|бежала
que|Il espère que son rêve se réalisera un jour.|Conjonction|что
veulent|Ils veulent faire une pause et se détendre.|Verbe|хотят
crâne|Le crâne humain est constitué de plusieurs os.|Nom masculin|череп
costaud|Il est costaud et peut soulever des poids lourds.|Adjectif|крепкий
arrière|Le jardin est à l'arrière de la maison.|Adverbe|задний
réussi|Elle a réussi son examen avec brio.|Adjectif|успешный
lit|Elle a lu un livre passionnant au lit hier soir.|Nom masculin|кровать
tous|Ils étaient tous présents à la réunion.|Pronom|все
mais|Il aime le chocolat, mais il ne peut pas en manger trop.|Conjonction|но
ont|Ils ont travaillé dur pour atteindre leurs objectifs.|Verbe|имеют
bouda|Elle bouda son frère pendant quelques heures.|Verbe|сердилась
étui|Il rangeait son téléphone dans son étui de protection.|Nom masculin|чехол
part|Il a pris part à une compétition sportive.|Nom féminin|часть
devient|Il devient de plus en plus compétent dans son travail.|Verbe|становится
obtenait|Il obtenait de bonnes notes à l'école.|Verbe|получал
intelligent|Il est intelligent et toujours prêt à apprendre de nouvelles choses.|Adjectif|умный
trop|Il a mangé trop de gâteau d'anniversaire.|Adverbe|слишком
salle|La salle était pleine de spectateurs enthousiastes.|Nom féminin|зал
courait|Il courait très vite lors de la course.|Verbe|бежал
recevoir|Elle espérait recevoir une lettre de son ami.|Verbe|получить
vilain|Il ne faut pas dire de vilaines choses sur les autres.|Adjectif|злой
bordenave|Bordenave est un nom de famille français.|Nom propre|Борденав
vrai|C'est vraiment ce que je ressens, c'est un sentiment vrai.|Adjectif|настоящий
savez|Savez-vous comment faire une tarte aux pommes ?|Verbe|знаете
ramener|Il a dû ramener son chien qui s'était échappé.|Verbe|принести назад
cuisine|Elle aime cuisiner des plats délicieux pour sa famille.|Nom féminin|кухня
goût|Le gâteau avait un goût sucré et délicieux.|Nom masculin|вкус
parlé|Il a parlé de ses projets pour l'avenir.|Verbe|говорил
croisés|Les doigts croisés apportent de la chance.|Adjectif|скрещенные
vieille|La vieille maison était pleine de caractère.|Adjectif|старый
calmer|Elle essayait de calmer le bébé en pleurs.|Verbe|успокаивать
bitude|C'était devenu une habitude de prendre un café le matin.|Nom féminin|привычка
amies|Elles étaient de très bonnes amies depuis l'enfance.|Nom féminin|подруги
mâcher|Il ne devrait pas mâcher de la gomme en classe.|Verbe|жевать
drôles|Ils racontaient des blagues drôles pendant la soirée.|Adjectif|смешные
cyrille|Cyrille est un prénom masculin en France.|Nom propre|Кирилл
faisant|Il était toujours occupé, faisant plusieurs choses à la fois.|Adjectif|делающий
rayures|Les rayures étaient à la mode sur les vêtements.|Nom féminin|полосы
pleurait|Le bébé pleurait et avait besoin d'attention.|Verbe|плакал
noirs|Ses cheveux noirs encadraient joliment son visage.|Adjectif|черные
tapé|Il a tapé un message rapide sur son téléphone.|Verbe|набрал
singe|Le singe était très amusant à regarder au zoo.|Nom masculin|обезьяна
protester|Ils ont décidé de protester contre les nouvelles règles.|Verbe|протестовать
direz|Que lui direz-vous lorsqu'elle reviendra ?|Verbe|скажете
prenez|Prenez votre temps pour prendre une décision.|Verbe|возьмите
trempé|Il était trempé de la pluie après avoir couru dehors.|Adjectif|мокрый
trouvaient|Ils se trouvaient dans une situation difficile.|Verbe|находились
seront|Ils seront là pour vous soutenir dans tous vos projets.|Verbe|будут
photographe|Le photographe a capturé des moments spéciaux lors du mariage.|Nom masculin|фотограф
ruisseau|Le ruisseau était bordé de magnifiques fleurs sauvages.|Nom masculin|ручей
reçoive|J'espère qu'il reçoive le cadeau à temps pour son anniversaire.|Verbe|получит
remontaient|Ils remontaient la colline avec effort.|Verbe|поднимались
voleurs|Les voleurs ont été arrêtés par la police.|Nom masculin|воры
par|Il est passé par la porte principale de l'école.|Préposition|через
jules|Jules est un prénom masculin en France.|Nom propre|Жюль
trichais|Il avoua qu'il trichais pendant le jeu de cartes.|Verbe|жульничал
brillait|Le soleil brillait fort dans le ciel d'été.|Verbe|светил
siffle|Il aime siffler en marchant dans la rue.|Verbe|свистеть
figure|Sa figure était pâle après avoir entendu la nouvelle.|Nom féminin|лицо
français|Il a appris à parler français en voyageant en France.|Nom masculin|француз
raies|Les raies du zèbre étaient nettes et distinctes.|Nom féminin|полосы
bocal|Elle a rangé les bonbons dans un bocal en verre.|Nom masculin|банка
policier|Le policier a enquêté sur le vol de la bijouterie.|Nom masculin|полицейский
met|Elle met de l'argent de côté pour ses vacances.|Verbe|кладет
pâtisserie|La pâtisserie avait de délicieuses pâtisseries françaises.|Nom féminin|пекарня
voiture|Il a lavé sa voiture avant le voyage.|Nom féminin|машина
blanche|La robe blanche était élégante et pure.|Adjectif|белый
monsieur|Monsieur Dupont était un homme gentil et respecté.|Nom masculin|господин
alcool|L'alcool est interdit aux mineurs.|Nom masculin|алкоголь
essayé|Elle a essayé de nouvelles recettes pour le dîner.|Verbe|попробовала
arrivais|J'arrivais toujours en retard à l'école.|Verbe|приходил
crie|Elle crie de joie quand elle gagne au jeu vidéo.|Verbe|кричит
originale|L'idée était très originale et créative.|Adjectif|оригинальный
poudre|La poudre était douce au toucher.|Nom féminin|порошок
cycliste|Le cycliste a parcouru des kilomètres en montagne.|Nom masculin|велосипедист
mange|Il aime manger des fruits pour le petit déjeuner.|Verbe|ест
focale|La longueur focale de l'objectif était réglée sur l'infini.|Nom féminin|фокусное расстояние
ridicule|Il portait un chapeau ridicule lors de la fête costumée.|Adjectif|смешной
leurs|Leurs efforts ont été récompensés par une victoire.|Pronom possessif|их
mangées|Les pommes de terre étaient bien mangées par tous.|Verbe|съедены
sauvaient|Ils sauvaient des vies en tant que pompiers courageux.|Verbe|спасали
remontaient|Ils remontaient la montagne en randonnée.|Verbe|поднимались
par|Il est passé par la porte principale de l'école.|Préposition|через
jules|Jules est un prénom masculin en France.|Nom propre|Жюль
trichais|Il avoua qu'il trichais pendant le jeu de cartes.|Verbe|жульничал
brillait|Le soleil brillait fort dans le ciel d'été.|Verbe|светил
siffle|Il aime siffler en marchant dans la rue.|Verbe|свистеть
figure|Sa figure était pâle après avoir entendu la nouvelle.|Nom féminin|лицо
français|Il a appris à parler français en voyageant en France.|Nom masculin|француз
raies|Les raies du zèbre étaient nettes et distinctes.|Nom féminin|полосы
bocal|Elle a rangé les bonbons dans un bocal en verre.|Nom masculin|банка
policier|Le policier a enquêté sur le vol de la bijouterie.|Nom masculin|полицейский
met|Elle met de l'argent de côté pour ses vacances.|Verbe|кладет
pâtisserie|La pâtisserie avait de délicieuses pâtisseries françaises.|Nom féminin|пекарня
voiture|Il a lavé sa voiture avant le voyage.|Nom masculin|машина
blanche|La robe blanche était élégante et pure.|Adjectif|белый
monsieur|Monsieur Dupont était un homme gentil et respecté.|Nom masculin|господин
alcool|L'alcool est interdit aux mineurs.|Nom masculin|алкоголь
essayé|Elle a essayé de nouvelles recettes pour le dîner.|Verbe|попробовала
arrivais|J'arrivais toujours en retard à l'école.|Verbe|приходил
crie|Elle crie de joie quand elle gagne au jeu vidéo.|Verbe|кричит
originale|L'idée était très originale et créative.|Adjectif|оригинальный
poudre|La poudre était douce au toucher.|Nom féminin|порошок
cycliste|Le cycliste a parcouru des kilomètres en montagne.|Nom masculin|велосипедист
mange|Il aime manger des fruits pour le petit déjeuner.|Verbe|ест
focale|La longueur focale de l'objectif était réglée sur l'infini.|Nom féminin|фокусное расстояние
ridicule|Il portait un chapeau ridicule lors de la fête costumée.|Adjectif|смешной
leurs|Leurs efforts ont été récompensés par une victoire.|Pronom possessif|их
mangées|Les pommes de terre étaient bien mangées par tous.|Verbe|съедены
sauvaient|Ils sauvaient des vies en tant que pompiers courageux.|Verbe|спасали
remontaient|Ils remontaient la montagne en randonnée.|Verbe|поднимались